6 10
2
MS....S...
.E.SE...M.
....M..E..
M......M..
..........
..........
---
.S..S...E.
.E..E.....
.M....E...
......M...
...M......
..........
